Adiantum	calcareum		Adiantum calcareum
Adiantum	lorentzii		Adiantum lorentzii
Aralia	warmingiana		Aralia warmingiana
Averrhoidium	paraguaiense		Averrhoidium paraguaiense
Begonia	reniformis		Begonia reniformis
Bomarea	edulis		Bomarea edulis
Brasiliopuntia	brasiliensis		Brasiliopuntia brasiliensis
Cavanillesia	umbellata		Cavanillesia umbellata
Cecropia	saxatilis		Cecropia saxatilis
Ceiba	pubiflora		Ceiba pubiflora
Cereus	jamacaru		Cereus jamacaru
Croton	rottlerifolius		Croton rottlerifolius
Ficus	calyptroceras		Ficus calyptroceras
Peperomia	gardneriana		Peperomia gardneriana
Phyllanthus	acuminatus		Phyllanthus acuminatus
Phytolacca	dioica		Phytolacca dioica
Sinningia	warmingii		Sinningia warmingii
Solanum	gardneri		Solanum gardneri
Solanum	oocarpum		Solanum oocarpum
Spathicarpa	gardneri		Spathicarpa gardneri
Trichilia	catigua		Trichilia catigua
Urera	baccifera		Urera baccifera
Vasconcellea	quercifolia		Vasconcellea quercifolia
Ficus	bonijesulapensis		Ficus bonijesulapensis
Trichilia	elegans		Trichilia elegans
